5 5
WWWWW
Wo..W
WC..W
W.oCW
WWWWW
