5 5
WWWWW
W..PW
W...W
W...W
WWWWW
