5 5
WWWWW
W.K.W
WPGCW
W.oCW
WWWWW
