5 5
WWWWWW
WP...W
W....W
W....W
WWWWWW
