5 5
WWWWWW
WP...W
W....W
W...CW
WWWWWW
