17 21
WWWWWWWWWWWWWWWWWWWWW
W..G......o.........W
W.WWWWWWW.W.WWWWWWW.W
WoW.....W.W.W.....WoW
W.W.WWW.W.W.W.WWW.W.W
W...oC....P.....Co..W
W.W.WWW.WWWWW.WWW.W.W
WoW.....W..oW.....WoW
W.WWWWW.W.C.W.WWWWW.W
W...........W.......W
W.WWWWW.W.o.W.WWWWW.W
WoW.........W...K.WoW
W.W.WWW.WWWWW.WWW.W.W
W...oC..........Co..W
W.W.WWW.W.W.W.WWW.W.W
W.......o.W.o.......W
WWWWWWWWWWWWWWWWWWWWW 