5 5
WWWWW
WP..W
W...W
W...W
WWWWW
