5 5
WWWWW
WP..W
W..CW
WKoGW
WWWWW
