5 5
WWWWW
W...W
W.P.W
W...W
WWWWW
