10 10
WWWWWWWWWW
W........W
W..P.....W
W........W
W........W
W........W
W........W
W........W
W....CCCCW
WWWWWWWWWW