10 15
WWWWWWWWWWWWWWW
W.....o.o.....W
W.WWW.WWW.WWW.W
WoW.....P.....W
W.W.WWW.WWW.W.W
W.K.oC...Co.G.W
W.W.WWW.WWW.W.W
WoW...........W
W.WWW.WWW.WWW.W
WWWWWWWWWWWWWWW
