10 10
WWWWWWWWWW
W........W
W..P...K.W
W........W
W.......GW
W........W
W........W
W......ooW
W.....oCCW
WWWWWWWWWW