10 10
WWWWWWWWWW
WC.......W
W..P.....W
W........W
W........W
W........W
W........W
W........W
W....CCCCW
WWWWWWWWWW